NO ./Assets/brickwall_2.xpm
SO ./Assets/stonewall.xpm
WE ./Assets/wood.xpm
EA ./Assets/wall_1.xpm

F 81,76,11
C 94,14,80



11111111111111111111
10000000000000000001
10000000000000000001
10000000000000000001
10000000000000000001
10000000000000000001
100000000000000000011111111
111111111111111111111111111
1000000W000000000001
10000000000000000001
10000000000000000001
11111111111111111111