SO ./Assets/stonewall.xpm
NO ./Assets/brickwall_2.xpm    
WE ./Assets/wood.xpm
EA ./Assets/wall_1.xpm

F 81,76,78
C 94,14,80

11111111111111111111111111111
10001000000000000000000000001
10001000000000000000000000001
10001000000000000000000000001
100010000N0000000000000000001
10000000000000000000000000001
10000000000000000000000000001
10000000000000000000000000001
10000000000000000000000000001
10000000000000000000000000001
10000000000000000000010000001
10000000000000000000010000001
10000000000000000000010000001
10000001000000000000010000001
10000011100000000000010000001
11111111111111111111111111111