NO ./Assets/brickwall_2.xpm
SO ./Assets/stonewall.xpm
WE ./Assets/wood.xpm
EA ./Assets/wall_1.xpm

F 81,76,78
C 94,14,80

1111111111111111
1000000000000001
1000000000000001
1000000000000001
1000000000000001
10000000N0000001
1000000000000001
1111111111111111