SO ./Assets/stonewall.xpm
NO ./Assets/yasser_1_.xpm    
WE ./Assets/wood.xpm
EA ./Assets/flag1.xpm

F 81,76,78
C 94,14,80

111111111111111111
100010000000000001
100010000000000001
100010000000000001
100000000N00000001
100000000000000001
100000000000000001
100000000000000001
111111111111111111