NO ./Assets/brickwall_2.xpm
SO ./Assets/wall_1.xpm
WE ./Assets/stonewall.xpm
EA ./Assets/wood.xpm

F 120,100,18
C 050,100,18

1111111111111
1000000000001
1001000000001
1000000000001
1000000000001
1000000000001
1000000000011
1000000000111
1000000001111
1111111111111
