NO ./Assets/flag1.xpm
SO ./Assets/brickwall_2.xpm
WE ./Assets/wood.xpm
EA ./Assets/yasser_1_.xpm

F 81,76,78
C 94,14,80

1111111111111111111111111111
1000000000000000000000000001
1000000000000000000000000001
1000000000000000000000000001
1000000000000000000000000001
1000000000000S00000000000001
1000000000000000000000000001
1000000000000000000000000001
1000000000000000000000000001
1000000000000000000000000001
1111111111111111111111111111