NO ./path_to_the_north_texture_NO
SO ./path_to_the_south_texture
WE ./path_to_the_west_texture
EA ./path_to_the_east_texture

F 120,100,18
C 050,100,18

111111111111111
100010000001111
100011000000111
100000000000011
1000000000000011111
1000000000000000001
1000000000000011111
100000000000001
100000111000001
111111111111111
